1111111111111111111111111111111111
1000000000000000000000000000000001
1000P00000000000000000000000000001
1000000000001111111111100000000001
1000000001111111111000000000000001
1000000000000000000000000000000001
1000000000010000000000000000000001
1000000000000000000000000000C00001
1000000000000000000000000000000001
1000000000000000000000000000000001
1000000000000000000000000000000001
1000000000000000000000000000000001
1000000000000000000000000000000001
1000000000000000000000000000000001
1000000000000000000000000000000001
1000000000000000000000000000000001
1000000000000000000000000000000001
10000000C0000000000000000000000001
1000000000000110000000000000000001
1000000000000100000000000000000001
10000000000111000000000000000E0001
1000000000000000000000000000000001
1111111111111111111111111111111111