111111
1P0C01
100P01
1C00E1
111111