111111
1P0001
111001
1C10E1
111111