111111
1P0C01
111101
1E1001
111111