111111
1P0C01
100001
1C00E0
111110